3 3 0
0 0 0 0 0 0 0 0
0 0 1 1 1 1 1 0
0 1 1 2 2 2 1 0
0 1 4 2 2 2 1 0
0 1 2 2 1 2 1 0
0 1 4 2 1 3 1 0
0 1 1 1 1 1 1 0
0 0 0 0 0 0 0 0
3 4 2 0 5 4 1 3 5 1