3 2 0
0 0 0 0 0 0 0 0
0 1 1 1 1 1 1 0
0 1 2 2 4 4 1 0
0 1 2 2 1 1 1 0
0 1 2 2 1 3 1 0
0 1 2 2 2 2 1 0
0 1 1 1 1 1 1 0
0 0 0 0 0 0 0 0
2 4 5 1 5 5 1