2 3 0
0 0 0 0 0 0 0 0
0 1 1 1 1 1 1 0
0 1 2 2 2 4 1 0
0 1 4 2 2 1 1 0
0 1 1 2 2 2 1 0
0 1 3 2 1 2 1 0
0 1 1 1 1 1 1 0
0 0 0 0 0 0 0 0
3 2 2 1 5 2 0 3 4 0