2 3 0
0 0 0 0 0 0 0 0
0 1 1 1 1 1 1 0
0 1 2 4 2 4 1 0
0 1 2 2 2 2 1 0
0 1 4 1 2 2 1 0
0 1 2 3 1 2 1 0
0 1 1 1 1 1 1 0
0 0 0 0 0 0 0 0
4 4 2 0 3 3 0 5 3 1 2 5 0