2 2 0
0 0 0 0 0 0 0 0
0 1 1 1 1 1 1 0
0 1 2 2 2 2 1 0
0 1 2 2 4 4 1 0
0 1 4 1 2 2 1 0
0 1 4 3 1 2 1 0
0 1 1 1 1 1 1 0
0 0 0 0 0 0 0 0
4 5 2 0 3 3 1 4 3 1 2 5 0