2 2 0
4 5 3 0 2 4 0 3 4 0 3 5 1
0 0 0 0 0 0 0 0
0 1 1 1 1 1 1 0
0 1 2 2 1 3 1 0
0 1 4 2 1 2 1 0
0 1 2 2 2 2 1 0
0 1 4 2 2 2 1 0
0 1 1 1 1 1 1 0
0 0 0 0 0 0 0 0