2 3 0
4 3 2 1 4 2 0 4 3 1 4 4 1
0 0 0 0 0 0 0 0
0 1 1 1 1 1 1 0
0 1 4 2 2 4 1 0
0 1 2 2 2 1 1 0
0 1 2 2 2 2 1 0
0 1 2 1 1 3 1 0
0 1 1 1 1 1 1 0
0 0 0 0 0 0 0 0