2 2 0
3 3 3 0 3 5 1 5 5 1
0 0 0 0 0 0 0 0
0 1 1 1 1 1 1 0
0 1 2 2 2 2 1 0
0 1 2 2 2 2 1 0
0 1 1 1 2 2 1 0
0 1 3 2 2 2 1 0
0 1 1 1 1 1 1 0
0 0 0 0 0 0 0 0