2 2 0
2 5 4 1 3 2 0
0 0 0 0 0 0 0 0
0 1 1 1 1 1 1 0
0 1 2 2 2 2 1 0
0 1 1 2 2 2 1 1
0 0 1 2 2 2 3 1
0 0 1 2 2 2 1 1
0 0 1 1 1 1 1 0
0 0 0 0 0 0 0 0