2 5 0
1 5 4 0
0 0 0 0 0 0 0 0
0 1 1 1 1 1 0 0
0 1 2 2 4 1 0 0
0 1 2 2 2 1 1 1
0 1 2 2 2 2 3 1
0 1 2 2 2 1 1 1
0 1 1 1 1 1 0 0
0 0 0 0 0 0 0 0