2 3 0
2 4 3 0 3 4 0
0 0 0 0 0 0 0 0
0 1 1 1 1 1 1 0
0 1 2 2 2 2 1 0
0 1 2 1 2 2 1 0
0 1 1 2 2 2 1 0
0 1 2 3 1 4 1 0
0 1 1 1 1 1 1 0
0 0 0 0 0 0 0 0