2 3 0
2 2 2 0 3 4 0
0 0 0 0 0 0 0 0
0 1 1 1 1 0 0 0
0 1 4 2 1 1 0 0
0 1 2 2 2 1 1 0
0 1 4 2 1 3 1 0
0 1 1 2 2 2 1 0
0 0 1 1 1 1 1 0
0 0 0 0 0 0 0 0