2 2 0
2 4 2 1 2 4 0
0 0 0 0 0 0 0 0
0 1 1 1 1 1 1 0
0 1 2 1 2 3 1 0
0 1 2 1 4 1 1 0
0 1 2 2 4 2 1 0
0 1 2 2 2 2 1 0
0 1 1 1 1 1 1 0
0 0 0 0 0 0 0 0